<style type='text/css'>
prewrap{word-break:break-all;white-space:pre-wrap;}
</style>
<prewrap>
sample sok writeing files...
git hub studying...
Thank you...
Good Bye!
</prewrap>
